100 100 100 100 100 100 100 100 100 100 100 100 100 100 100
100 100 100 100 100 100 100 100 100 100 100 100 100 100 100
100 100 100 100 100 100 100 100 100 100 100 100 100 100 100
100 100 100 100 100 100 100 100 100 100 100 100 100 100 100
100 100 100 100 100 100 100 100 100 100 100 100 100 100 100
100 100 100 100 100 100 100 100 100 100 100 100 100 100 100
100 100 100 100 100 100 100 100 100 100 100 100 100 100 100
100 100 100 100 100 100 100 100 100 100 100 100 100 100 100
100 100 100 100 100 100 100 100 100 100 100 100 100 100 100
100 100 100 100 100 100 100 100 100 100 100 100 100 100 100
100 100 100 100 100 100 100 100 100 100 100 100 100 100 100
100 100 100 100 100 100 100 100 100 100 100 100 100 100 100
100 100 100 100 100 100 100 100 100 100 100 100 100 100 100
100 100 100 100 100 100 100 100 100 100 100 100 100 100 100
100 100 100 100 100 100 100 100 100 100 100 100 100 100 100
---
200 200 200 200 200 200 200 200 200 200 200 200 200 200 200
200 -1 -1 -1 300 -1 -1 -1 -1 300 -1 -1 -1 -1 200
200 -1 0 300 -1 -1 -1 -1 300 -1 -1 -1 -1 -1 200
200 -1 -1 -1 -1 -1 -1 300 -1 -1 -1 -1 300 -1 200
200 -1 -1 -1 200 -1 300 -1 200 -1 -1 300 200 -1 200
200 -1 -1 -1 -1 300 -1 -1 -1 -1 300 -1 -1 -1 200
200 -1 -1 -1 300 -1 -1 -1 -1 300 -1 -1 -1 -1 200
200 -1 -1 300 -1 -1 -1 -1 300 -1 -1 -1 -1 -1 200
200 -1 -1 -1 200 -1 -1 300 200 -1 -1 -1 200 -1 200
200 -1 -1 -1 -1 -1 300 -1 -1 -1 -1 300 -1 -1 200
200 -1 -1 -1 -1 300 -1 -1 -1 -1 300 -1 -1 -1 200
200 -1 -1 -1 300 -1 -1 -1 -1 300 -1 -1 -1 -1 200
200 -1 -1 300 200 -1 -1 -1 200 -1 -1 -1 1 -1 200
200 -1 -1 -1 -1 -1 -1 300 -1 -1 -1 -1 300 -1 200
200 200 200 200 200 200 200 200 200 200 200 200 200 200 200
---
-1 -1 -1 -1 -1 -1 -1 -1 -1 -1 -1 -1 -1 -1 -1
-1 -1 -1 -1 -1 -1 -1 -1 -1 -1 -1 -1 -1 500 -1
-1 -1 -1 -1 -1 -1 -1 -1 -1 -1 -1 -1 -1 500 -1
-1 -1 -1 -1 -1 -1 -1 -1 -1 -1 -1 -1 -1 500 -1
-1 -1 -1 -1 -1 -1 -1 -1 -1 -1 -1 -1 -1 500 -1
-1 -1 -1 -1 -1 -1 -1 -1 -1 -1 -1 -1 -1 500 -1
-1 -1 -1 -1 -1 -1 -1 -1 -1 -1 -1 -1 -1 500 -1
-1 -1 -1 -1 -1 -1 -1 -1 -1 -1 -1 -1 -1 500 -1
-1 -1 -1 -1 -1 -1 -1 -1 -1 -1 -1 -1 -1 500 -1
-1 -1 -1 -1 -1 -1 -1 -1 -1 -1 -1 -1 -1 500 -1
-1 -1 -1 -1 -1 -1 -1 -1 -1 -1 -1 -1 -1 500 -1
-1 -1 -1 -1 -1 -1 -1 -1 -1 -1 -1 -1 -1 500 -1
-1 -1 -1 -1 -1 -1 -1 -1 -1 -1 -1 -1 -1 500 -1
-1 500 500 500 500 500 500 500 500 500 500 500 500 500 -1
-1 -1 -1 -1 -1 -1 -1 -1 -1 -1 -1 -1 -1 -1 -1