{
  "properties": {
    "stageName": "Stage 2_Large",
    "maxShifts": 15,
    "width": 23,
    "height": 23
  },
  "layers": {
    "tile": [
      [
        100, 100, 100, 100, 100, 100, 100, 100, 100, 100, 100, 100, 100, 100,
        100, 100, 100, 100, 100, 100, 100, 100, 100
      ],
      [
        100, 100, 100, 100, 100, 100, 100, 100, 100, 100, 100, 100, 100, 100,
        100, 100, 100, 100, 100, 100, 100, 100, 100
      ],
      [
        100, 100, 100, 100, 100, 100, 100, 100, 100, 100, 100, 100, 100, 100,
        100, 100, 100, 100, 100, 100, 100, 100, 100
      ],
      [
        100, 100, 100, 100, 100, 100, 100, 100, 100, 100, 100, 100, 100, 100,
        100, 100, 100, 100, 100, 100, 100, 100, 100
      ],
      [
        100, 100, 100, 100, 100, 100, 100, 100, 100, 100, 100, 100, 100, 100,
        100, 100, 100, 100, 100, 100, 100, 100, 100
      ],
      [
        100, 100, 100, 100, 100, 100, 100, 100, 100, 100, 100, 100, 100, 100,
        100, 100, 100, 100, 100, 100, 100, 100, 100
      ],
      [
        100, 100, 100, 100, 100, 100, 100, 100, 100, 100, 100, 100, 100, 100,
        100, 100, 100, 100, 100, 100, 100, 100, 100
      ],
      [
        100, 100, 100, 100, 100, 100, 100, 100, 100, 100, 100, 100, 100, 100,
        100, 100, 100, 100, 100, 100, 100, 100, 100
      ],
      [
        100, 100, 100, 100, 100, 100, 100, 100, 100, 100, 100, 100, 100, 100,
        100, 100, 100, 100, 100, 100, 100, 100, 100
      ],
      [
        100, 100, 100, 100, 100, 100, 100, 100, 100, 100, 100, 100, 100, 100,
        100, 100, 100, 100, 100, 100, 100, 100, 100
      ],
      [
        100, 100, 100, 100, 100, 100, 100, 100, 100, 100, 100, 100, 100, 100,
        100, 100, 100, 100, 100, 100, 100, 100, 100
      ],
      [
        100, 100, 100, 100, 100, 100, 100, 100, 100, 100, 100, 100, 100, 100,
        100, 100, 100, 100, 100, 100, 100, 100, 100
      ],
      [
        100, 100, 100, 100, 100, 100, 100, 100, 100, 100, 100, 100, 100, 100,
        100, 100, 100, 100, 100, 100, 100, 100, 100
      ],
      [
        100, 100, 100, 100, 100, 100, 100, 100, 100, 100, 100, 100, 100, 100,
        100, 100, 100, 100, 100, 100, 100, 100, 100
      ],
      [
        100, 100, 100, 100, 100, 100, 100, 100, 100, 100, 100, 100, 100, 100,
        100, 100, 100, 100, 100, 100, 100, 100, 100
      ],
      [
        100, 100, 100, 100, 100, 100, 100, 100, 100, 100, 100, 100, 100, 100,
        100, 100, 100, 100, 100, 100, 100, 100, 100
      ],
      [
        100, 100, 100, 100, 100, 100, 100, 100, 100, 100, 100, 100, 100, 100,
        100, 100, 100, 100, 100, 100, 100, 100, 100
      ],
      [
        100, 100, 100, 100, 100, 100, 100, 100, 100, 100, 100, 100, 100, 100,
        100, 100, 100, 100, 100, 100, 100, 100, 100
      ],
      [
        100, 100, 100, 100, 100, 100, 100, 100, 100, 100, 100, 100, 100, 100,
        100, 100, 100, 100, 100, 100, 100, 100, 100
      ],
      [
        100, 100, 100, 100, 100, 100, 100, 100, 100, 100, 100, 100, 100, 100,
        100, 100, 100, 100, 100, 100, 100, 100, 100
      ],
      [
        100, 100, 100, 100, 100, 100, 100, 100, 100, 100, 100, 100, 100, 100,
        100, 100, 100, 100, 100, 100, 100, 100, 100
      ],
      [
        100, 100, 100, 100, 100, 100, 100, 100, 100, 100, 100, 100, 100, 100,
        100, 100, 100, 100, 100, 100, 100, 100, 100
      ],
      [
        100, 100, 100, 100, 100, 100, 100, 100, 100, 100, 100, 100, 100, 100,
        100, 100, 100, 100, 100, 100, 100, 100, 100
      ]
    ],
    "ground": [
      [
        200, 200, 200, 200, 200, 200, 200, 200, 200, 200, 200, 200, 200, 200,
        200, 200, 200, 200, 200, 200, 200, 200, 200
      ],
      [
        200, -1, -1, -1, -1, -1, 300, -1, -1, -1, -1, -1, -1, 300, -1, -1, -1,
        -1, -1, -1, -1, -1, 200
      ],
      [
        200, -1, -1, -1, -1, 300, -1, -1, -1, -1, -1, -1, 300, -1, -1, -1, -1,
        -1, -1, 300, -1, -1, 200
      ],
      [
        200, -1, -1, 0, 300, -1, -1, -1, -1, -1, -1, 300, -1, -1, -1, -1, -1,
        -1, 300, -1, -1, -1, 200
      ],
      [
        200, -1, -1, -1, -1, -1, -1, -1, -1, -1, 300, -1, -1, -1, -1, -1, -1,
        300, -1, -1, -1, -1, 200
      ],
      [
        200, -1, -1, -1, -1, 200, -1, -1, -1, 300, 200, -1, -1, -1, -1, 200,
        300, -1, -1, -1, 200, -1, 200
      ],
      [
        200, -1, -1, -1, -1, -1, -1, -1, 300, -1, -1, -1, -1, -1, -1, 300, -1,
        -1, -1, -1, -1, -1, 200
      ],
      [
        200, -1, -1, -1, -1, -1, -1, 300, -1, -1, -1, -1, -1, -1, 300, -1, -1,
        -1, -1, -1, -1, -1, 200
      ],
      [
        200, -1, -1, -1, -1, -1, 300, -1, -1, -1, -1, -1, -1, 300, -1, -1, -1,
        -1, -1, -1, -1, -1, 200
      ],
      [
        200, -1, -1, -1, -1, 300, -1, -1, -1, -1, -1, -1, 300, -1, -1, -1, -1,
        -1, -1, 300, -1, -1, 200
      ],
      [
        200, -1, -1, -1, 300, 200, -1, -1, -1, -1, 200, 300, -1, -1, -1, 200,
        -1, -1, 300, -1, 200, -1, 200
      ],
      [
        200, -1, -1, -1, -1, -1, -1, -1, -1, -1, 300, -1, -1, -1, -1, -1, -1,
        300, -1, -1, -1, -1, 200
      ],
      [
        200, -1, -1, -1, -1, -1, -1, -1, -1, 300, -1, -1, -1, -1, -1, -1, 300,
        -1, -1, -1, -1, -1, 200
      ],
      [
        200, -1, -1, -1, -1, -1, -1, -1, 300, -1, -1, -1, -1, -1, -1, 300, -1,
        -1, -1, -1, -1, -1, 200
      ],
      [
        200, -1, -1, -1, -1, -1, -1, 300, -1, -1, -1, -1, -1, -1, 300, -1, -1,
        -1, -1, -1, -1, -1, 200
      ],
      [
        200, -1, -1, -1, -1, 200, 300, -1, -1, -1, 200, -1, -1, 300, -1, 200,
        -1, -1, -1, -1, 200, -1, 200
      ],
      [
        200, -1, -1, -1, -1, 300, -1, -1, -1, -1, -1, -1, 300, -1, -1, -1, -1,
        -1, -1, 300, -1, -1, 200
      ],
      [
        200, -1, -1, -1, 300, -1, -1, -1, -1, -1, -1, 300, -1, -1, -1, -1, -1,
        -1, 300, -1, -1, -1, 200
      ],
      [
        200, -1, -1, -1, -1, -1, -1, -1, -1, -1, 300, -1, -1, -1, -1, -1, -1,
        300, -1, -1, -1, -1, 200
      ],
      [
        200, -1, -1, -1, -1, -1, -1, -1, -1, 300, -1, -1, -1, -1, -1, -1, 300,
        -1, -1, 1, -1, -1, 200
      ],
      [
        200, -1, -1, -1, -1, 200, -1, -1, 300, -1, 200, -1, -1, -1, -1, 200, -1,
        -1, -1, -1, 200, -1, 200
      ],
      [
        200, -1, -1, -1, -1, -1, -1, 300, -1, -1, -1, -1, -1, -1, 300, -1, -1,
        -1, -1, -1, -1, -1, 200
      ],
      [
        200, 200, 200, 200, 200, 200, 200, 200, 200, 200, 200, 200, 200, 200,
        200, 200, 200, 200, 200, 200, 200, 200, 200
      ]
    ],
    "sky": [
      [
        -1, -1, -1, -1, -1, -1, -1, -1, -1, -1, -1, -1, -1, -1, -1, -1, -1, -1,
        -1, -1, -1, -1, -1
      ],
      [
        -1, -1, -1, -1, -1, -1, -1, -1, -1, -1, -1, -1, -1, -1, -1, -1, -1, -1,
        -1, 500, -1, -1, -1
      ],
      [
        -1, -1, -1, -1, -1, -1, -1, -1, -1, -1, -1, -1, -1, -1, -1, -1, -1, -1,
        -1, 500, -1, -1, -1
      ],
      [
        -1, -1, -1, -1, -1, -1, -1, -1, -1, -1, -1, -1, -1, -1, -1, -1, -1, -1,
        -1, 500, -1, -1, -1
      ],
      [
        -1, -1, -1, -1, -1, -1, -1, -1, -1, -1, -1, -1, -1, -1, -1, -1, -1, -1,
        -1, 500, -1, -1, -1
      ],
      [
        -1, -1, -1, -1, -1, -1, -1, -1, -1, -1, -1, -1, -1, -1, -1, -1, -1, -1,
        -1, 500, -1, -1, -1
      ],
      [
        -1, -1, -1, -1, -1, -1, -1, -1, -1, -1, -1, -1, -1, -1, -1, -1, -1, -1,
        -1, 500, -1, -1, -1
      ],
      [
        -1, -1, -1, -1, -1, -1, -1, -1, -1, -1, -1, -1, -1, -1, -1, -1, -1, -1,
        -1, 500, -1, -1, -1
      ],
      [
        -1, -1, -1, -1, -1, -1, -1, -1, -1, -1, -1, -1, -1, -1, -1, -1, -1, -1,
        -1, 500, -1, -1, -1
      ],
      [
        -1, -1, -1, -1, -1, -1, -1, -1, -1, -1, -1, -1, -1, -1, -1, -1, -1, -1,
        -1, 500, -1, -1, -1
      ],
      [
        -1, -1, -1, -1, -1, -1, -1, -1, -1, -1, -1, -1, -1, -1, -1, -1, -1, -1,
        -1, 500, -1, -1, -1
      ],
      [
        -1, -1, -1, -1, -1, -1, -1, -1, -1, -1, -1, -1, -1, -1, -1, -1, -1, -1,
        -1, 500, -1, -1, -1
      ],
      [
        -1, -1, -1, -1, -1, -1, -1, -1, -1, -1, -1, -1, -1, -1, -1, -1, -1, -1,
        -1, 500, -1, -1, -1
      ],
      [
        -1, -1, -1, -1, -1, -1, -1, -1, -1, -1, -1, -1, -1, -1, -1, -1, -1, -1,
        -1, 500, -1, -1, -1
      ],
      [
        -1, -1, -1, -1, -1, -1, -1, -1, -1, -1, -1, -1, -1, -1, -1, -1, -1, -1,
        -1, 500, -1, -1, -1
      ],
      [
        -1, -1, -1, -1, -1, -1, -1, -1, -1, -1, -1, -1, -1, -1, -1, -1, -1, -1,
        -1, 500, -1, -1, -1
      ],
      [
        -1, -1, -1, -1, -1, -1, -1, -1, -1, -1, -1, -1, -1, -1, -1, -1, -1, -1,
        -1, 500, -1, -1, -1
      ],
      [
        -1, -1, -1, -1, -1, -1, -1, -1, -1, -1, -1, -1, -1, -1, -1, -1, -1, -1,
        -1, 500, -1, -1, -1
      ],
      [
        -1, -1, -1, -1, -1, -1, -1, -1, -1, -1, -1, -1, -1, -1, -1, -1, -1, -1,
        -1, 500, -1, -1, -1
      ],
      [
        -1, 500, 500, 500, 500, 500, 500, 500, 500, 500, 500, 500, 500, 500,
        500, 500, 500, 500, 500, 500, 500, 500, -1
      ],
      [
        -1, -1, -1, -1, -1, -1, -1, -1, -1, -1, -1, -1, -1, -1, -1, -1, -1, -1,
        -1, 500, -1, -1, -1
      ],
      [
        -1, -1, -1, -1, -1, -1, -1, -1, -1, -1, -1, -1, -1, -1, -1, -1, -1, -1,
        -1, 500, -1, -1, -1
      ],
      [
        -1, -1, -1, -1, -1, -1, -1, -1, -1, -1, -1, -1, -1, -1, -1, -1, -1, -1,
        -1, -1, -1, -1, -1
      ]
    ]
  }
}
